srpen
9 9 9 9 9 9 9 9 9 9 9 9 9 9 9 9 9 9 9 9 9 
9 1 1 1 0 0 0 0 0 0 0 0 0 0 0 0 0 e e e 9 
9 1 1 1 9 0 0 z z z z z z z 0 0 9 e e e 9 
9 0 0 0 9 0 0 9 9 9 9 9 9 9 0 0 9 0 0 0 9 
9 0 0 0 9 0 0 f f f f f f f 0 0 9 0 0 0 9 
9 0 0 0 9 0 0 0 0 0 0 0 0 0 0 0 9 0 0 0 9 
9 0 0 0 9 0 0 0 0 9 9 9 0 0 0 0 9 0 0 0 9 
9 0 V 0 a 0 0 0 9 9 9 9 9 0 0 0 a 0 0 0 9 
9 0 0 0 9 0 0 0 0 0 0 0 0 0 0 0 9 0 0 0 9 
9 0 0 0 9 0 0 t t t t t t t 0 0 9 0 0 0 9 
9 0 0 0 9 0 0 9 9 9 9 9 9 9 0 0 9 0 0 0 9 
9 2 2 2 9 0 0 0 0 0 0 0 0 0 0 0 9 r r r 9 
9 2 2 2 0 3 3 3 3 3 3 3 3 3 3 3 0 r r r 9 
9 9 9 9 9 9 9 9 9 9 B 9 9 9 9 9 9 9 9 9 9 