Kral
9 9 9 9 9 9 9 9 9 9 9 9 9 9 9 9 9 9 9 9 9
9 0 0 0 0 0 0 0 0 0 0 0 0 0 0 0 0 0 0 0 9
9 0 0 0 0 0 0 0 0 0 0 0 0 0 0 0 0 0 0 0 9 
9 0 0 0 0 0 0 0 0 0 0 0 0 0 0 0 0 0 0 0 9
9 0 0 0 0 0 0 0 0 0 0 0 0 0 0 0 0 0 0 0 9 
9 0 0 0 0 0 0 2 0 2 0 2 0 2 0 0 0 0 0 0 9
9 0 0 0 0 0 0 2 2 2 2 2 2 2 0 0 0 0 0 0 9
9 0 0 0 0 0 0 2 2 2 2 2 2 2 0 0 0 0 0 0 9
9 0 0 0 0 0 0 2 2 2 2 2 2 2 0 0 0 0 0 0 9
9 0 0 0 0 0 9 9 9 9 9 9 9 9 9 0 0 0 0 0 9
9 0 0 V 0 0 0 0 0 0 0 0 0 0 0 0 0 0 0 0 9
9 0 0 0 0 0 0 0 0 0 0 0 0 0 0 0 0 0 0 0 9
9 0 0 0 0 0 0 0 0 0 0 0 0 0 0 0 0 0 0 0 9
9 9 9 9 9 9 9 9 9 9 B 9 9 9 9 9 9 9 9 9 9 

