box
9 9 9 9 9 9 9 9 9 9 9 9 9 9 9 9 9 9 9 9 9 
9 0 V 0 0 0 0 0 2 0 0 0 2 0 0 0 0 0 0 0 9 
9 0 0 0 0 0 0 0 9 0 0 0 9 0 0 0 0 0 0 0 9 
9 0 a 0 0 3 3 3 9 a a a 9 3 3 3 0 0 a 0 9 
9 0 a 0 0 9 9 9 9 9 9 9 9 9 9 9 0 0 a 0 9 
9 0 a 0 0 9 0 0 0 0 0 0 0 0 0 9 0 0 a 0 9 
9 0 a 0 0 0 0 1 z z p z z 1 0 0 0 0 a 0 9 
9 0 a 0 0 0 0 1 z z p z z 1 0 0 0 0 a 0 9 
9 0 a 0 0 9 0 0 0 0 0 0 0 0 0 9 0 0 a 0 9 
9 0 a 0 0 9 9 9 9 9 B 9 9 9 9 9 0 0 a 0 9 
9 0 a 0 0 j j j 9 a a a 9 j j j 0 0 a 0 9 
9 0 0 0 0 0 0 0 9 0 0 0 9 0 0 0 0 0 0 0 9 
9 0 0 0 0 0 0 0 2 0 0 0 2 0 0 0 0 0 0 0 9 
9 9 9 9 9 9 9 9 9 9 9 9 9 9 9 9 9 9 9 9 9 