kostka
9 9 9 9 9 9 9 9 9 9 9 9 9 9 9 9 9 9 9 9 9 
9 0 0 0 0 0 0 0 0 0 0 0 0 0 0 0 0 0 0 0 9 
9 0 0 1 0 9 9 9 9 9 0 9 9 9 9 9 0 1 0 0 9 
9 0 0 1 0 9 0 0 0 0 0 0 0 0 0 9 0 1 0 0 9 
9 0 0 1 0 9 0 j 0 0 0 0 0 j 0 9 0 1 0 0 9 
9 0 0 1 0 9 0 0 0 3 0 3 0 0 0 9 0 1 0 0 9 
9 V 0 1 0 9 0 j 0 0 2 0 0 j 0 9 0 1 0 0 9 
9 0 0 1 0 9 0 0 0 3 0 3 0 0 0 9 0 1 0 0 9 
9 0 0 1 0 9 0 0 0 0 0 0 0 0 0 9 0 1 0 0 9 
9 0 0 1 0 9 0 r 0 0 f 0 0 r 0 9 0 1 0 0 9 
9 0 0 1 0 9 0 0 t 0 0 0 t 0 0 9 0 1 0 0 9 
9 0 0 1 0 9 9 9 9 9 9 9 9 9 9 9 0 1 0 0 9 
9 0 0 0 0 0 0 0 0 0 B 0 0 0 0 0 0 0 0 0 9 
9 9 9 9 9 9 9 9 9 9 9 9 9 9 9 9 9 9 9 9 9 