Mydlo
9 9 9 9 9 9 9 9 9 9 9 9 9 9 9 9 9 9 9 9 9
9 0 0 0 0 0 0 0 0 0 0 0 0 0 0 0 0 0 0 0 9
9 0 0 0 0 0 0 0 0 0 9 0 0 0 0 0 0 0 0 0 9
9 0 0 0 1 0 0 0 0 0 9 0 0 0 0 0 0 0 0 0 9
9 0 0 1 1 1 0 0 0 0 9 0 0 0 3 0 3 0 0 0 9 
9 0 0 1 2 1 0 0 0 0 9 0 0 3 0 3 0 3 0 0 9 
9 0 0 1 1 1 0 0 0 0 9 0 0 0 3 0 3 0 0 0 9  
9 0 0 0 1 0 0 0 0 0 9 0 0 3 0 3 0 3 0 0 9
9 0 0 0 0 0 0 0 0 0 B 0 0 0 3 0 3 0 0 0 9
9 0 0 0 0 0 0 0 0 0 9 0 0 0 0 0 0 0 0 0 9  
9 0 0 0 0 0 0 0 0 0 9 0 0 0 0 0 0 0 0 0 9
9 0 0 0 V 0 0 0 0 0 9 0 0 0 0 0 0 0 0 0 9
9 0 0 0 0 0 0 0 0 0 9 0 0 0 0 0 0 0 0 0 9
9 9 9 9 9 9 9 9 9 9 9 9 9 9 9 9 9 9 9 9 9 

