strop
9 9 9 9 9 9 9 9 9 9 9 9 9 9 9 9 9 9 9 9 9
9 0 0 0 0 0 0 0 0 0 0 0 0 0 0 0 0 0 0 0 9
9 0 3 3 3 3 3 3 3 3 3 3 3 3 3 3 3 3 3 0 9 
9 0 0 0 0 0 0 0 0 0 0 0 0 0 0 0 0 0 0 0 9
9 0 0 0 0 0 0 0 0 0 9 0 0 0 0 0 0 0 0 0 9  
9 0 0 0 1 0 1 0 1 0 9 0 e 0 e 0 e 0 0 0 9 
9 V 0 0 0 1 0 1 0 0 9 0 0 e 0 e 0 0 0 0 9   
9 0 0 0 1 0 1 0 1 0 9 0 e 0 e 0 e 0 0 0 9
9 0 0 0 0 1 0 1 0 0 9 0 0 e 0 e 0 0 0 0 9
9 0 0 0 1 0 1 0 1 0 9 0 e 0 e 0 e 0 0 0 9 
B 0 0 0 0 0 0 0 0 0 9 0 0 0 0 0 0 0 0 0 9
9 0 0 0 0 0 0 0 0 0 9 0 0 0 0 0 0 0 0 0 9
9 0 0 0 0 0 0 0 0 0 2 0 0 0 0 0 0 0 0 0 9
9 9 9 9 9 9 9 9 9 9 9 9 9 9 9 9 9 9 9 9 9