fourl
9 9 9 9 9 9 9 9 9 9 9 9 9 9 9 9 9 9 9 9 9 
9 0 0 0 0 0 0 9 0 0 0 0 0 9 0 0 0 0 0 0 9 
9 0 V 0 0 0 0 9 0 t t t 0 9 0 0 0 0 0 0 9 
9 0 0 0 9 d d 9 0 t t t 0 9 d d 9 0 0 0 9 
9 0 0 0 9 9 9 9 0 t t t 0 9 9 9 9 0 0 0 9 
9 0 2 0 0 0 0 0 0 0 0 0 0 0 0 0 0 0 2 0 9 
9 0 2 0 0 0 p j j j B j j j p 0 0 0 2 0 9 
9 0 2 0 0 0 0 0 0 0 0 0 0 0 0 0 0 0 2 0 9 
9 0 0 0 9 9 9 9 0 0 0 0 0 9 9 9 9 0 0 0 9 
9 0 0 0 9 z z 9 0 2 2 2 0 9 z z 9 0 0 0 9 
9 0 0 0 0 0 0 9 0 2 2 2 0 9 0 0 0 0 0 0 9 
9 0 0 0 0 0 0 9 0 2 2 2 0 9 0 0 0 0 0 0 9 
9 0 0 0 f 0 0 9 0 0 0 0 0 9 0 0 f 0 0 0 9 
9 9 9 9 9 9 9 9 9 9 9 9 9 9 9 9 9 9 9 9 9 