cerven
9 9 9 9 9 9 9 9 9 9 9 9 9 9 9 9 9 9 9 9 9 
9 j j j j j j j j j j j j j j j j j j j 9 
9 0 0 0 0 0 0 0 0 f 3 f 0 0 0 0 0 0 0 0 9 
9 0 0 0 0 0 9 9 9 9 9 9 9 9 9 0 0 0 0 0 9 
9 0 0 0 0 0 0 9 0 0 0 0 0 9 0 0 0 0 0 0 9 
9 0 t t t 0 0 9 0 z z z 0 9 0 0 t t t 0 9 
9 0 t t t 0 0 9 0 z t z 0 9 0 0 t t t 0 9 
9 0 1 1 1 0 0 9 0 j 0 j 0 9 0 0 1 1 1 0 9 
9 0 1 1 1 0 0 9 0 0 0 0 0 9 0 0 1 1 1 0 9 
9 0 r r r 0 0 9 0 0 0 0 0 9 0 0 r r r 0 9 
9 0 0 0 0 0 9 9 9 9 0 9 9 9 9 0 0 0 0 0 9 
9 0 0 0 0 0 0 0 0 0 0 0 0 0 0 0 0 0 0 0 9 
9 0 0 0 0 0 0 0 0 0 V 0 0 0 0 0 0 0 0 0 9 
9 9 9 9 9 9 9 9 9 9 B 9 9 9 9 9 9 9 9 9 9 