dort
9 9 9 9 9 9 9 9 9 9 9 9 9 9 9 9 9 9 9 9 9 
9 0 0 0 3 0 0 0 0 0 0 0 0 0 0 0 3 0 0 0 9 
9 0 0 0 3 0 0 0 z 0 z 0 z 0 0 0 3 0 0 0 9 
9 0 0 0 3 0 0 0 0 z 0 z 0 0 0 0 3 0 0 0 9 
9 0 0 0 3 0 9 0 0 0 1 0 0 0 9 0 3 0 0 0 9 
9 0 0 0 3 0 9 0 0 0 2 0 0 0 9 0 3 0 0 0 9 
9 V 0 0 f 0 9 0 0 9 B 9 0 0 9 0 t 0 0 0 9 
9 0 0 0 3 0 9 j 0 9 d 9 0 j 9 0 3 0 0 0 9 
9 0 0 0 3 0 9 0 0 9 1 9 0 0 9 0 3 0 0 0 9 
9 0 0 0 3 0 9 0 0 9 1 9 0 0 9 0 3 0 0 0 9 
9 0 0 0 3 0 9 0 0 0 0 0 0 0 9 0 3 0 0 0 9 
9 0 0 0 3 0 9 0 0 0 0 0 0 0 9 0 3 0 0 0 9 
9 0 0 0 3 0 0 0 0 0 0 0 0 0 0 0 3 0 0 0 9 
9 9 9 9 9 9 9 9 9 9 9 9 9 9 9 9 9 9 9 9 9 