lilie
9 9 9 9 9 9 9 9 9 9 9 9 9 9 9 9 9 9 9 9 9
9 0 0 0 0 0 0 0 0 0 0 0 0 0 2 0 0 0 0 0 9
9 0 0 0 0 0 0 0 0 0 0 0 0 0 9 0 1 0 0 0 9
9 0 0 0 0 0 0 0 0 r r r 0 0 9 0 1 0 0 0 9
9 0 0 0 0 0 0 0 r r r r r 0 9 0 1 0 0 0 9
9 0 0 0 0 0 0 0 r r r r r 0 9 0 1 0 0 0 9
9 V 0 0 0 0 0 0 r r 2 r r 0 9 0 1 0 0 0 9  
9 0 0 0 0 0 0 0 r r r r r 0 9 0 1 0 0 0 9
9 0 0 0 0 0 0 0 r r r r r 0 9 0 1 0 0 0 9
9 0 0 0 0 0 0 0 0 r r r 0 0 9 0 1 0 0 0 9
9 0 0 0 0 0 0 0 0 0 0 0 0 0 9 0 1 0 0 0 9
9 9 9 9 9 9 9 9 9 9 9 9 9 9 9 0 1 0 0 0 9
B 0 0 0 3 3 3 3 3 3 3 3 3 0 0 0 0 0 0 0 9
9 9 9 9 9 9 9 9 9 9 9 9 9 9 9 9 9 9 9 9 9