pocitace
9 9 9 9 9 9 9 9 9 9 9 9 9 9 9 9 9 9 9 9 9 
9 0 0 0 0 0 0 0 0 0 9 0 0 0 0 0 0 0 0 0 9 
9 0 0 p p p p 0 0 0 9 0 0 0 p p p p 0 0 9 
9 0 0 p 0 0 0 p 0 0 2 0 0 p 0 0 0 0 0 0 9 
9 0 0 p 0 0 0 p 0 0 9 0 0 p 0 0 0 0 0 0 9 
9 0 0 p 0 0 0 p 0 0 9 0 0 p 0 0 0 0 0 0 9 
9 0 0 p p p p 0 0 0 9 0 0 p 0 0 0 0 0 0 9 
9 0 0 p 0 0 0 0 0 d B d 0 p 0 0 0 0 0 0 9 
9 0 0 p 0 0 0 0 0 0 9 0 0 p 0 0 0 0 0 0 9 
9 0 0 p 0 0 0 0 0 0 9 0 0 p 0 0 0 0 0 0 9 
9 0 0 p 0 0 0 0 0 0 V 0 0 p 0 0 0 0 0 0 9 
9 0 0 p 0 0 0 0 0 0 9 0 0 0 p p p p 0 0 9 
9 0 0 0 0 0 0 0 0 0 9 0 0 0 0 0 0 0 0 0 9 
9 9 9 9 9 9 9 9 9 9 9 9 9 9 9 9 9 9 9 9 9 