leden
9 9 9 9 9 9 9 9 9 9 B 9 9 9 9 9 9 9 9 9 9
9 0 1 0 1 0 1 0 1 0 0 0 1 0 1 0 1 0 1 0 9
9 0 0 0 0 0 0 0 0 0 0 0 0 0 0 0 0 0 0 0 9
9 0 0 0 0 0 0 0 0 0 0 0 0 0 0 0 0 0 0 0 9
9 0 0 0 0 0 0 0 0 0 0 0 0 0 0 0 0 0 0 0 9 
9 0 0 0 0 0 0 0 0 0 0 0 0 0 0 0 0 0 0 0 9 
9 V 0 0 0 0 0 0 0 0 0 0 0 0 0 0 0 0 0 0 9  
9 0 0 0 0 0 0 0 0 0 j 0 0 0 0 0 0 0 0 0 9
9 0 0 0 0 0 0 0 0 j j j 0 0 0 0 0 0 0 0 9
9 0 0 0 0 0 0 0 j j 3 j j 0 0 0 0 0 0 0 9  
9 0 0 0 9 0 0 j j 3 9 3 j j 0 0 9 0 0 0 9
9 0 0 0 9 0 j j 3 j 9 j 3 j j 0 9 0 0 0 9
9 0 0 0 9 j j 3 j j j j j 3 j j 9 0 0 0 9
9 9 9 9 9 9 9 9 9 9 9 9 9 9 9 9 9 9 9 9 9 
