ulice
9 9 9 9 9 9 9 9 9 9 9 9 9 9 9 9 9 9 9 9 9 
9 0 0 0 0 0 0 0 z 0 9 0 z 0 0 0 0 0 0 0 9 
9 0 0 0 0 0 0 0 9 0 d 0 9 0 0 0 0 0 0 0 9 
9 0 0 0 0 0 0 9 9 9 9 9 9 9 0 0 0 0 0 0 9 
9 0 0 0 a a 0 9 0 0 0 0 0 9 0 a a 0 0 0 9 
9 0 0 0 a 0 0 0 0 0 0 0 0 0 0 0 a 0 0 0 9 
9 0 0 0 a 0 9 3 9 0 0 0 9 3 9 0 a 0 0 0 9 
9 0 V 0 a 0 9 3 9 0 0 0 9 3 9 0 a 0 0 0 9 
9 0 0 0 a 0 9 3 9 t p t 9 3 9 0 a 0 0 0 9 
9 0 0 0 a 0 9 3 9 0 0 0 9 3 9 0 a 0 0 0 9 
9 0 0 a a 0 9 3 9 0 B 0 9 3 9 0 a a 0 0 9 
9 0 0 0 0 0 0 0 9 0 0 0 9 0 0 0 0 0 0 0 9 
9 0 0 0 0 0 0 0 9 0 0 0 9 0 0 0 0 0 0 0 9 
9 9 9 9 9 9 9 9 9 9 9 9 9 9 9 9 9 9 9 9 9 