Král
9 9 9 9 9 9 9 9 9 9 9 9 9 9 9 9 9 9 9 9 9
9 0 0 0 0 0 0 0 0 0 0 0 0 0 0 0 0 0 0 0 9
9 0 0 0 0 0 0 0 0 0 0 0 0 0 0 0 0 0 0 0 9 
9 0 0 0 0 0 0 0 0 0 0 0 0 0 0 0 0 0 0 0 9
9 0 0 0 0 0 0 0 0 0 0 0 0 0 0 0 0 0 0 0 9 
9 0 0 0 0 0 0 2 0 2 0 2 0 2 0 0 0 0 0 0 9
9 0 0 0 0 0 0 2 2 2 2 2 2 2 0 0 0 0 0 0 9
9 0 0 0 0 0 0 2 2 2 2 2 2 2 0 0 0 0 0 0 9
9 0 0 0 0 0 0 2 2 2 2 2 2 2 0 0 0 0 0 0 9
9 0 0 0 0 0 9 9 9 9 9 9 9 9 9 0 0 0 0 0 9
9 0 0 11 0 0 0 0 0 0 0 0 0 0 0 0 0 0 0 0 9
9 0 0 0 0 0 0 0 0 0 0 0 0 0 0 0 0 0 0 0 9
9 0 0 0 0 0 0 0 0 0 0 0 0 0 0 0 0 0 0 0 9
9 9 9 9 9 9 9 9 9 9 10 9 9 9 9 9 9 9 9 9 9 

