Mydlo
9 9 9 9 9 9 9 9 9 9 9 9 9 9 9 9 9 9 9 9 9
9 0 0 0 0 0 0 0 0 0 0 0 0 0 0 0 0 0 0 0 9
9 0 0 0 0 0 0 0 0 0 9 0 0 0 0 0 0 0 0 0 9
9 0 0 0 0 0 0 0 0 0 9 0 0 0 0 0 0 0 0 0 9
9 0 0 0 0 0 0 0 0 0 9 0 0 0 0 0 0 0 0 0 9 
9 0 0 0 0 0 0 0 0 0 9 0 0 0 0 0 0 0 0 0 9 
9 0 0 0 0 0 0 0 0 0 9 0 0 0 0 0 0 0 0 0 9  
9 0 0 0 0 0 0 0 0 0 B 0 0 0 0 0 0 0 0 0 9
9 0 0 0 0 0 0 0 0 0 0 0 0 0 0 0 0 0 0 0 9
9 0 0 0 0 0 0 0 0 0 9 0 0 0 0 0 0 0 0 0 9  
9 0 0 0 0 0 0 0 0 0 9 0 0 0 0 0 0 0 0 0 9
9 0 0 0 V 0 0 0 0 0 9 0 0 0 0 0 0 0 0 0 9
9 0 0 0 0 0 0 0 0 0 9 0 0 0 0 0 0 0 0 0 9
9 9 9 9 9 9 9 9 9 9 9 9 9 9 9 9 9 9 9 9 9 
