Diamond
9 9 9 9 9 9 9 9 9 9 9 9 9 9 9 9 9 9 9 9 9 
9 0 0 0 0 0 0 0 0 0 0 0 0 0 0 0 0 0 0 0 9
9 0 0 0 0 0 0 0 0 0 0 0 0 0 0 0 0 0 0 0 9  
9 0 0 0 0 1 1 1 1 1 1 1 1 1 1 1 0 0 0 0 9
9 0 0 0 0 0 0 0 0 0 0 0 0 0 0 0 0 0 0 0 9  
9 0 0 0 0 0 0 0 0 0 0 0 0 0 0 0 0 0 0 0 9 
9 0 0 11 0 0 0 1 1 1 1 1 1 1 0 0 0 0 0 0 9   
9 0 0 0 0 0 0 0 0 0 0 0 0 0 0 0 0 0 0 0 9
9 0 0 0 0 0 0 0 0 0 0 0 0 0 0 0 0 0 0 0 9
9 0 0 0 0 0 0 0 0 1 1 1 0 0 0 0 0 0 0 0 9 
9 0 0 0 0 0 0 0 0 0 0 0 0 0 0 0 0 0 0 0 9
9 0 0 0 0 0 0 0 0 0 2 0 0 0 0 0 0 0 0 0 10
9 0 0 0 0 0 0 0 0 0 0 0 0 0 0 0 0 0 0 0 9
9 9 9 9 9 9 9 9 9 9 9 9 9 9 9 9 9 9 9 9 9

